name:TestArea
size:1600x1600
spawn:Spawn1 4 5
spawn:NorthDoorSpawn 25 3
spawn:SouthDoorSpawn 25 46
doorway:NorthDoor 0 25 2 TestRoom EastDoorSpawn
doorway:SouthDoor 0 25 47 TestRoom WestDoorSpawn
music:Greensleeves-1-greensleeves-2096-6987.ogg
row:0 !!!!!!!!!!!!!!!!!!!!!!!!!!!!!!!!!!!!!!!!!!!!!!!!!!
row:1 !%%%%%%%%%%%%%%%%%%%%%%%%%%%%%%%%%%%%%%%%%%%%%%%%!
row:2 !%#######################!######################%!
row:3 !%''''''''''''''''''''''''''''''''''''''''''''''%!
row:4 !%'''(((((((''''''''''''''''''''''''''''''''''''%!
row:5 !%'''(*****('''''''''''/////''''''''''''''''''''%!
row:6 !%'''(+++++('''''''''''/////''''''''''''''''''''%!
row:7 !%'''(+-.-+('''''''''''/////''''''''''''''''''''%!
row:8 !%'''(+-.-+('''''''''''/////''''''''''''''''''''%!
row:9 !%'''(+++++('''''''''''/////''''''''''''''''''''%!
row:10 !%'''(((+((('''''''''''/////''''''''''''''''''''%!
row:11 !%'''***+***'''''''''''/////''''''''''''''''''''%!
row:12 !%'''''''''''''''''''''/////''''''''''''''''''''%!
row:13 !%'''''''''''''''''''''/////''''''''''''''''''''%!
row:14 !%'''''''''''''''''''''/////''''''''''''''''''''%!
row:15 !%'''''''''''''''''''''/////''''''''''''''''''''%!
row:16 !%'''''''''''''''''''''/////''''''''''''''''''''%!
row:17 !%'''''''''''''''''''''/////''''''''''''''''''''%!
row:18 !%'''''''''''''''''''''/////''''''''''''''''''''%!
row:19 !%'''''''''''''''''''''/////''''''''''''''''''''%!
row:20 !%'''''''''''''''''''''/////''''''''''''''''''''%!
row:21 !%'''''''''''''''''''''/////''''''''''''''''''''%!
row:22 !%'''''''''''''''''''''/////''''''''''''''''''''%!
row:23 !%'''''''''''''''''''''/////''''''''''''''''''''%!
row:24 !%'''''''''''''''''''''/////''''''''''''''''''''%!
row:25 !%'''''''''''''''''''''/////''''''''''''''''''''%!
row:26 !%'''''''''''''''''''''/////''''''''''''''''''''%!
row:27 !%'''''''''''''''''''''/////''''''''''''''''''''%!
row:28 !%'''''''''''''''''''''/////''''''''''''''''''''%!
row:29 !%'''''''''''''''''''''/////''''''''''''''''''''%!
row:30 !%'''''''''''''''''''''/////''''''''''''''''''''%!
row:31 !%'''''''''''''''''''''/////''''''''''''''''''''%!
row:32 !%'''''''''''''''''''''/////''''''''''''''''''''%!
row:33 !%'''''''''''''''''''''/////''''''''''''''''''''%!
row:34 !%'''''''''''''''''''''/////''''''''''''''''''''%!
row:35 !%'''''''''''''''''''''/////''''''''''''''''''''%!
row:36 !%'''''''''''''''''''''/////''''''''''''''''''''%!
row:37 !%'''''''''''''''''''''/////''''''''''''''''''''%!
row:38 !%'''''''''''''''''''''/////''''''''''''''''''''%!
row:39 !%'''''''''''''''''''''/////''''''''''''''''''''%!
row:40 !%'''''''''''''''''''''/////''''''''''''''''''''%!
row:41 !%'''''''''''''''''''''/////''''''''''''''''''''%!
row:42 !%'''''''''''''''''''''/////''''''''''''''''''''%!
row:43 !%'''''''''''''''''''''/////''''''''''''''''''''%!
row:44 !%''''''''''''''''''''''''''''''''''''''''''''''%!
row:45 !%''''''''''''''''''''''''''''''''''''''''''''''%!
row:46 !%''''''''''''''''''''''''''''''''''''''''''''''%!
row:47 !%%%%%%%%%%%%%%%%%%%%%%%%!%%%%%%%%%%%%%%%%%%%%%%%!
row:48 !################################################!
row:49 !!!!!!!!!!!!!!!!!!!!!!!!!!!!!!!!!!!!!!!!!!!!!!!!!!
end:end